Sản phẩm: Đồng hồ thông minh Xiaomi Amazfit Bip
Giá: 1.400.000₫
Thông tin:

Màn hình

Công nghệ màn hình	Transflective LCD
Kích thước màn hình	1.28 inch
Độ phân giải	176 x 176 pixels
Chất liệu mặt	Kính cường lực Gorilla Class 3
Đường kính mặt	31.1 mm

Cấu hình

CPU	1.2 GHz Dual Core - M200S
Bộ nhớ trong	Đang cập nhật
Hệ điều hành	Đang cập nhật
Kết nối được với hệ điều hành	iOS, Android 4.4 trở lên
Cổng sạc	Đế sạc nam châm

Pin

Thời gian sử dụng pin	Khoảng 45 ngày, Khoảng 22 giờ khi sử dụng GPS
Thời gian sạc	Khoảng 2 giờ
Dung lượng pin	190 mAh

Tiện ích & kết nối

Theo dõi sức khỏe	Theo dõi giấc ngủ, Đo nhịp tim, Tính lượng Calories tiêu thụ, Đếm số bước chân, Tính quãng đường chạy, Chế độ luyện tập
Hiển thị thông báo	Cuộc gọi, Nội dung tin nhắn, Tin nhắn, Zalo, Messenger (Facebook), Line, Viber
Tiện ích khác	Báo thức, Màn hình luôn hiển thị, Từ chối cuộc gọi, Đồng hồ bấm giờ, Rung thông báo, Thay mặt đồng hồ
Kết nối	Bluetooth v4.0, GPS
Camera	Không có

Dây đeo

Độ dài dây	Đang cập nhật
Độ rộng dây	2 cm
Chất liệu dây	Silicone
Dây có thể tháo rời	Có

Thông tin khác

Chất liệu khung viền	Nhựa
Ngôn ngữ	Tiếng Anh, Ứng dụng tiếng Anh, Ứng dụng tiếng Việt
Kích thước	Dài 3.2 cm - Rộng 3.1 cm - Dày 1.1 cm
Trọng lượng	32g