Sản phẩm: Vòng tay thông minh Zeblaze Plug C
Giá: 290.000₫
Thông tin:

Màn hình

Công nghệ màn hình	Transflective LCD
Kích thước màn hình	0.85 inch
Độ phân giải	72 x 144 pixels
Chất liệu mặt	Kính cường lực
Đường kính mặt	18.8 mm

Cấu hình

CPU	Đang cập nhật
Bộ nhớ trong	Không có
Hệ điều hành	Không có
Kết nối được với hệ điều hành	iOS 8 trở lên, Android 4.4 trở lên
Cổng sạc	Cổng sạc USB trên thân vòng đeo tay

Pin

Thời gian sử dụng pin	Khoảng 7 ngày
Thời gian sạc	Khoảng 1.5 giờ
Dung lượng pin	90 mAh

Tiện ích & kết nối

Theo dõi sức khỏe	Theo dõi giấc ngủ, Đo nhịp tim, Tính lượng Calories tiêu thụ, Đếm số bước chân, Chế độ luyện tập
Hiển thị thông báo	Cuộc gọi, Tin nhắn, Zalo, Line
Tiện ích khác	Màn hình luôn hiển thị, Đồng hồ bấm giờ, Tìm điện thoại, Nhắc nhở
Kết nối	Bluetooth
Camera	

Dây đeo

Độ dài dây	19.5 cm
Độ rộng dây	1.5 cm
Chất liệu dây	Silicone
Dây có thể tháo rời	Có

Thông tin khác

Ngôn ngữ	Tiếng Anh, Ứng dụng tiếng Anh
Kích thước	45.6 mm - 18.8 mm - 12.5 mm
Trọng lượng	70 g