Sản phẩm: Apple Watch S5 44mm viền nhôm dây cao su
Giá: 11.990.000₫
Thông tin:

Màn hình

Công nghệ màn hình	OLED
Kích thước màn hình	1.78 inch
Độ phân giải	448 x 368 pixels
Chất liệu mặt	Ion-X strengthened glass
Đường kính mặt	44 mm

Cấu hình

CPU	Apple S5 64 bit
Bộ nhớ trong	32 GB
Hệ điều hành	watchOS 6.0
Kết nối được với hệ điều hành	iOS 13 trở lên
Cổng sạc	Đế sạc nam châm

Pin

Thời gian sử dụng pin	Khoảng 18 giờ
Thời gian sạc	Khoảng 2 giờ
Dung lượng pin	Đang cập nhật

Tiện ích & kết nối

Theo dõi sức khỏe	Đo nhịp tim, Tính lượng Calories tiêu thụ, Đếm số bước chân, Tính quãng đường chạy, Chế độ luyện tập
Hiển thị thông báo	Cuộc gọi, Nội dung tin nhắn, Tin nhắn, Zalo, Messenger (Facebook), Line, Viber
Tiện ích khác	Phát hiện té ngã, Báo thức, Nghe nhạc với tai nghe Bluetooth, Gọi điện trên đồng hồ, Từ chối cuộc gọi, Dự báo thời tiết, La bàn, Điều khiển chơi nhạc, Thay mặt đồng hồ
Kết nối	Wifi, Bluetooth v5.0, GPS
Camera	Không có

Dây đeo

Độ dài dây	Đang cập nhật
Độ rộng dây	Đang cập nhật
Chất liệu dây	Silicone
Dây có thể tháo rời	Có

Thông tin khác

Chất liệu khung viền	Nhôm
Ngôn ngữ	Tiếng Anh, Tiếng Việt
Kích thước	Đường kính 44 mm - Dày 10.7 mm
Trọng lượng	36.7 gram