Sản phẩm: Đồng hồ thông minh Samsung Galaxy Watch Active R500
Giá: 4.490.000₫
Thông tin:

Màn hình

Công nghệ màn hình	AMOLED
Kích thước màn hình	1.1 inch
Độ phân giải	360 x 360 pixels
Chất liệu mặt	Kính cường lực Gorilla Class 3
Đường kính mặt	40 mm

Cấu hình

CPU	Exynos 9110
Bộ nhớ trong	4 GB
Hệ điều hành	OS TIZEN
Kết nối được với hệ điều hành	iOS 10 trở lên, Android 5.0
Cổng sạc	Đế sạc nam châm

Pin

Thời gian sử dụng pin	Khoảng 5 ngày
Thời gian sạc	Khoảng 2 giờ
Dung lượng pin	270 mAh

Tiện ích & kết nối

Theo dõi sức khỏe	Theo dõi giấc ngủ, Đo nhịp tim, Tính lượng Calories tiêu thụ, Đếm số bước chân, Tính quãng đường chạy, Chế độ luyện tập
Hiển thị thông báo	Cuộc gọi, Nội dung tin nhắn, Tin nhắn, Zalo, Messenger (Facebook), Line, Viber
Tiện ích khác	Báo thức, Nghe nhạc với tai nghe Bluetooth, Màn hình luôn hiển thị, Đồng hồ bấm giờ, Điều khiển chơi nhạc, Rung thông báo, Thay mặt đồng hồ
Kết nối	Bluetooth v4.2
Camera	Không có

Dây đeo

Độ dài dây	22.6 cm
Độ rộng dây	2 cm
Chất liệu dây	Silicone
Dây có thể tháo rời	Có

Thông tin khác

Chất liệu khung viền	Nhôm
Ngôn ngữ	Tiếng Anh, Tiếng Việt
Kích thước	Dài 39.5 mm - Rộng 39.5 mm -Dày 10.5 mm
Trọng lượng	25 g